NO ./asd
SO ./asd
WE ./ads
l
EA ./asd

F 255,255,255
l
C 255,255,255

		1111111111111111111111111
		1000000000110000000000001
		1011000001110000000000001
		1001000000000000000000001
111111111011000001110000000000001
100000000011000001110111111111111
11110111111111011100000010001
11110111111111011101010010001
11000000110101011100000010001
10000000000000000000000010001
100000000000000011010100d0001
1101d111110101011111d11110N0111
1111T111 1110101 101011010001
11111111 1111111 111111111111